grpc.client.by-destination.abandoned-error: grpc_destination=samples.api.GreeterService/SayHello, grpc_destination_full=greeter/samples.api.GreeterService/SayHello, grpc_method=SayHello, grpc_service=samples.api.GreeterService	RATE
grpc.client.by-destination.active: grpc_destination=samples.api.GreeterService/SayHello, grpc_destination_full=greeter/samples.api.GreeterService/SayHello, grpc_method=SayHello, grpc_service=samples.api.GreeterService	GAUGE
grpc.client.by-destination.cancelled-by-deadline-propagation: grpc_destination=samples.api.GreeterService/SayHello, grpc_destination_full=greeter/samples.api.GreeterService/SayHello, grpc_method=SayHello, grpc_service=samples.api.GreeterService	RATE
grpc.client.by-destination.cancelled: grpc_destination=samples.api.GreeterService/SayHello, grpc_destination_full=greeter/samples.api.GreeterService/SayHello, grpc_method=SayHello, grpc_service=samples.api.GreeterService	RATE
grpc.client.by-destination.deadline-propagated: grpc_destination=samples.api.GreeterService/SayHello, grpc_destination_full=greeter/samples.api.GreeterService/SayHello, grpc_method=SayHello, grpc_service=samples.api.GreeterService	RATE
grpc.client.by-destination.eps: grpc_destination=samples.api.GreeterService/SayHello, grpc_destination_full=greeter/samples.api.GreeterService/SayHello, grpc_method=SayHello, grpc_service=samples.api.GreeterService	RATE
grpc.client.by-destination.network-error: grpc_destination=samples.api.GreeterService/SayHello, grpc_destination_full=greeter/samples.api.GreeterService/SayHello, grpc_method=SayHello, grpc_service=samples.api.GreeterService	RATE
grpc.client.by-destination.rps: grpc_destination=samples.api.GreeterService/SayHello, grpc_destination_full=greeter/samples.api.GreeterService/SayHello, grpc_method=SayHello, grpc_service=samples.api.GreeterService	RATE
grpc.client.by-destination.status: grpc_code=OK, grpc_destination=samples.api.GreeterService/SayHello, grpc_destination_full=greeter/samples.api.GreeterService/SayHello, grpc_method=SayHello, grpc_service=samples.api.GreeterService	RATE
grpc.client.by-destination.status: grpc_code=UNKNOWN, grpc_destination=samples.api.GreeterService/SayHello, grpc_destination_full=greeter/samples.api.GreeterService/SayHello, grpc_method=SayHello, grpc_service=samples.api.GreeterService	RATE
grpc.client.by-destination.timings: grpc_destination=samples.api.GreeterService/SayHello, grpc_destination_full=greeter/samples.api.GreeterService/SayHello, grpc_method=SayHello, grpc_service=samples.api.GreeterService, percentile=p0	GAUGE
grpc.client.by-destination.timings: grpc_destination=samples.api.GreeterService/SayHello, grpc_destination_full=greeter/samples.api.GreeterService/SayHello, grpc_method=SayHello, grpc_service=samples.api.GreeterService, percentile=p100	GAUGE
grpc.client.by-destination.timings: grpc_destination=samples.api.GreeterService/SayHello, grpc_destination_full=greeter/samples.api.GreeterService/SayHello, grpc_method=SayHello, grpc_service=samples.api.GreeterService, percentile=p50	GAUGE
grpc.client.by-destination.timings: grpc_destination=samples.api.GreeterService/SayHello, grpc_destination_full=greeter/samples.api.GreeterService/SayHello, grpc_method=SayHello, grpc_service=samples.api.GreeterService, percentile=p90	GAUGE
grpc.client.by-destination.timings: grpc_destination=samples.api.GreeterService/SayHello, grpc_destination_full=greeter/samples.api.GreeterService/SayHello, grpc_method=SayHello, grpc_service=samples.api.GreeterService, percentile=p95	GAUGE
grpc.client.by-destination.timings: grpc_destination=samples.api.GreeterService/SayHello, grpc_destination_full=greeter/samples.api.GreeterService/SayHello, grpc_method=SayHello, grpc_service=samples.api.GreeterService, percentile=p98	GAUGE
grpc.client.by-destination.timings: grpc_destination=samples.api.GreeterService/SayHello, grpc_destination_full=greeter/samples.api.GreeterService/SayHello, grpc_method=SayHello, grpc_service=samples.api.GreeterService, percentile=p99	GAUGE
grpc.client.by-destination.timings: grpc_destination=samples.api.GreeterService/SayHello, grpc_destination_full=greeter/samples.api.GreeterService/SayHello, grpc_method=SayHello, grpc_service=samples.api.GreeterService, percentile=p99_6	GAUGE
grpc.client.by-destination.timings: grpc_destination=samples.api.GreeterService/SayHello, grpc_destination_full=greeter/samples.api.GreeterService/SayHello, grpc_method=SayHello, grpc_service=samples.api.GreeterService, percentile=p99_9	GAUGE
grpc.client.total.abandoned-error:	RATE
grpc.client.total.active:	GAUGE
grpc.client.total.cancelled-by-deadline-propagation:	RATE
grpc.client.total.cancelled:	RATE
grpc.client.total.deadline-propagated:	RATE
grpc.client.total.eps:	RATE
grpc.client.total.network-error:	RATE
grpc.client.total.rps:	RATE
grpc.client.total.status: grpc_code=OK	RATE
grpc.client.total.status: grpc_code=UNKNOWN	RATE
grpc.client.total.timings: percentile=p0	GAUGE
grpc.client.total.timings: percentile=p100	GAUGE
grpc.client.total.timings: percentile=p50	GAUGE
grpc.client.total.timings: percentile=p90	GAUGE
grpc.client.total.timings: percentile=p95	GAUGE
grpc.client.total.timings: percentile=p98	GAUGE
grpc.client.total.timings: percentile=p99	GAUGE
grpc.client.total.timings: percentile=p99_6	GAUGE
grpc.client.total.timings: percentile=p99_9	GAUGE
grpc.server.by-destination.abandoned-error: grpc_destination=samples.api.GreeterService/SayHello, grpc_method=SayHello, grpc_service=samples.api.GreeterService	RATE
grpc.server.by-destination.active: grpc_destination=samples.api.GreeterService/SayHello, grpc_method=SayHello, grpc_service=samples.api.GreeterService	GAUGE
grpc.server.by-destination.cancelled-by-deadline-propagation: grpc_destination=samples.api.GreeterService/SayHello, grpc_method=SayHello, grpc_service=samples.api.GreeterService	RATE
grpc.server.by-destination.cancelled: grpc_destination=samples.api.GreeterService/SayHello, grpc_method=SayHello, grpc_service=samples.api.GreeterService	RATE
grpc.server.by-destination.deadline-propagated: grpc_destination=samples.api.GreeterService/SayHello, grpc_method=SayHello, grpc_service=samples.api.GreeterService	RATE
grpc.server.by-destination.eps: grpc_destination=samples.api.GreeterService/SayHello, grpc_method=SayHello, grpc_service=samples.api.GreeterService	RATE
grpc.server.by-destination.network-error: grpc_destination=samples.api.GreeterService/SayHello, grpc_method=SayHello, grpc_service=samples.api.GreeterService	RATE
grpc.server.by-destination.rps: grpc_destination=samples.api.GreeterService/SayHello, grpc_method=SayHello, grpc_service=samples.api.GreeterService	RATE
grpc.server.by-destination.status: grpc_code=OK, grpc_destination=samples.api.GreeterService/SayHello, grpc_method=SayHello, grpc_service=samples.api.GreeterService	RATE
grpc.server.by-destination.status: grpc_code=UNKNOWN, grpc_destination=samples.api.GreeterService/SayHello, grpc_method=SayHello, grpc_service=samples.api.GreeterService	RATE
grpc.server.by-destination.timings: grpc_destination=samples.api.GreeterService/SayHello, grpc_method=SayHello, grpc_service=samples.api.GreeterService, percentile=p0	GAUGE
grpc.server.by-destination.timings: grpc_destination=samples.api.GreeterService/SayHello, grpc_method=SayHello, grpc_service=samples.api.GreeterService, percentile=p100	GAUGE
grpc.server.by-destination.timings: grpc_destination=samples.api.GreeterService/SayHello, grpc_method=SayHello, grpc_service=samples.api.GreeterService, percentile=p50	GAUGE
grpc.server.by-destination.timings: grpc_destination=samples.api.GreeterService/SayHello, grpc_method=SayHello, grpc_service=samples.api.GreeterService, percentile=p90	GAUGE
grpc.server.by-destination.timings: grpc_destination=samples.api.GreeterService/SayHello, grpc_method=SayHello, grpc_service=samples.api.GreeterService, percentile=p95	GAUGE
grpc.server.by-destination.timings: grpc_destination=samples.api.GreeterService/SayHello, grpc_method=SayHello, grpc_service=samples.api.GreeterService, percentile=p98	GAUGE
grpc.server.by-destination.timings: grpc_destination=samples.api.GreeterService/SayHello, grpc_method=SayHello, grpc_service=samples.api.GreeterService, percentile=p99	GAUGE
grpc.server.by-destination.timings: grpc_destination=samples.api.GreeterService/SayHello, grpc_method=SayHello, grpc_service=samples.api.GreeterService, percentile=p99_6	GAUGE
grpc.server.by-destination.timings: grpc_destination=samples.api.GreeterService/SayHello, grpc_method=SayHello, grpc_service=samples.api.GreeterService, percentile=p99_9	GAUGE
grpc.server.total.abandoned-error:	RATE
grpc.server.total.active:	GAUGE
grpc.server.total.cancelled-by-deadline-propagation:	RATE
grpc.server.total.cancelled:	RATE
grpc.server.total.deadline-propagated:	RATE
grpc.server.total.eps:	RATE
grpc.server.total.network-error:	RATE
grpc.server.total.rps:	RATE
grpc.server.total.status: grpc_code=OK	RATE
grpc.server.total.status: grpc_code=UNKNOWN	RATE
grpc.server.total.timings: percentile=p0	GAUGE
grpc.server.total.timings: percentile=p100	GAUGE
grpc.server.total.timings: percentile=p50	GAUGE
grpc.server.total.timings: percentile=p90	GAUGE
grpc.server.total.timings: percentile=p95	GAUGE
grpc.server.total.timings: percentile=p98	GAUGE
grpc.server.total.timings: percentile=p99	GAUGE
grpc.server.total.timings: percentile=p99_6	GAUGE
grpc.server.total.timings: percentile=p99_9	GAUGE
